sex	Combo-sex	Sex
_title_NUTP003	Title
age_in_months	Decimal-1
origin_nearest_health_centre	Combo-origin_nearest_health_centre
_title_NUTP006	Title
_title_NUTP007	Title
admission_type	Combo-admission_type
referred_by	Combo-referred_by
_title_NUTP010	Title
_title_NUTP011	Title
height_cm	Decimal-1
admission_weight_height	Combo-admission_weight_height
admission_muac_mm	Numeric
admission_oedema	Combo-admission_oedema
_title_NUTP016	Title
admission_rdt_malaria	Combo-admission_rdt_malaria
_title_NUTP018	Title
_title_NUTP019	Title
tfc_stay_last_2_months	Combo-tfc_stay_last_2_months
tfc_stay_last_2_months_outcome	Combo-tfc_stay_last_2_months_outcome
_title_NUTP022	Title
smc_1	Boolean
smc_2	Boolean
smc_3	Boolean
smc_4	Boolean
smc_not_current_year	Boolean
smc_unknown	Boolean
_title_NUTP029	Title
_title_NUTP030	Title
vaccinal_status_card	Combo-vaccinal_status_card
vaccination_pentavalent	Combo-vaccination_pentavalent
vaccination_pentavalent_last_dose_in_hosp	Combo-vaccination_pentavalent_last_dose_in_hosp
vaccination_afp	Combo-vaccination_afp
vaccination_afp_last_dose_in_hosp	Combo-vaccination_afp_last_dose_in_hosp
vaccination_measles	Combo-vaccination_measles
vaccination_measles_last_dose_in_hosp	Combo-vaccination_measles_last_dose_in_hosp
vaccination_pcv	Combo-vaccination_pcv
vaccination_pcv_last_dose_in_hosp	Combo-vaccination_pcv_last_dose_in_hosp
vaccination_rotavirus	Combo-vaccination_rotavirus
vaccination_rotavirus_last_dose_in_hosp	Combo-vaccination_rotavirus_last_dose_in_hosp
mother_vaccination_tt	Combo-mother_vaccination_tt
mother_vaccination_tt_last_dose_in_hosp	Combo-mother_vaccination_tt_last_dose_in_hosp
_title_NUTP044	Title
_title_NUTP045	Title
discharge_height_cm	Decimal-1
discharge_muac_mm	Numeric
_title_NUTP048	Title
comments	Coded
_title_NUTP050	Title
