_title_MH002	Title
encounter_location_first	Combo-encounter_location_first
encounter_location_first_other_details	Coded
referred_by	Combo-referred_by
mh_hospitalization	Combo-mh_hospitalization
mh_precipitating_factor	Combo-mh_precipitating_factor
complaint_main_other	Coded
complaint_main_type	Combo-complaint_main_type
_title_MH010	Title
_title_MH011	Title
_title_MH012	Title
consultation_mh_with_psychiatrist_msf	Boolean
consultation_mh_with_psychologist_msf	Boolean
consultation_mh_with_psychiatrist_nonmsf	Boolean
consultation_mh_with_psychologist_nonmsf	Boolean
_title_MH017	Coded
_title_MH018	Title
diagnosis_psychiatric_impression	Combo-diagnosis_psychiatric_impression
diagnosis_psychiatric_impression_other_details	Coded
_title_MH021	Title
_title_MH022	Title
mh_therapy_type	Combo-mh_therapy_type
mh_therapy_type_other_details	Coded
_title_MH025	Title
_title_MH026	Title
_title_MH027	Title
mh_medication_current_at_baseline_1	Combo-mh_medication_current_at_baseline_1
mh_medication_current_at_baseline_dosage_1	Coded
mh_medication_current_at_baseline_2	Combo-mh_medication_current_at_baseline_2
mh_medication_current_at_baseline_dosage_2	Coded
mh_medication_current_at_baseline_3	Combo-mh_medication_current_at_baseline_3
mh_medication_current_at_baseline_dosage_3	Coded
_title_MH034	Title
medication_psychiatric_1	Combo-medication_psychiatric_1
medication_psychiatric_dosage_1	Coded
medication_psychiatric_2	Combo-medication_psychiatric_2
medication_psychiatric_dosage_2	Coded
medication_psychiatric_3	Combo-medication_psychiatric_3
medication_psychiatric_dosage_3	Coded
medication_psychiatric_other	Coded
medication_psychiatric_dosage_other	Coded
_title_MH043	Title
_title_MH044	Title
antecedents_psychiatric	Combo-antecedents_psychiatric
antecedents_psychiatric_other_details	Coded
_title_MH047	Title
_title_MH048	Title
referral_psycho	Combo-referral_psycho
referral_psycho_details	Coded
_title_MH051	Title
_title_MH052	Title
gaf	Combo-gaf
srq20	Numeric
ptsd_score	Numeric
_title_MH056	Title
mh_hts01	Boolean
mh_hts02	Boolean
mh_hts03	Boolean
mh_hts04	Boolean
mh_hts05	Boolean
mh_hts06	Boolean
mh_hts07	Boolean
mh_hts08	Boolean
mh_hts09	Boolean
mh_hts10	Boolean
mh_hts11	Boolean
mh_hts12	Boolean
mh_hts13	Boolean
mh_hts14	Boolean
mh_hts15	Boolean
mh_hts16	Boolean
mh_hts17	Boolean
mh_hts18	Boolean
mh_hts19	Boolean
mh_hts20	Boolean
mh_hts21	Boolean
mh_hts22	Boolean
mh_hts23	Boolean
mh_hts24	Boolean
mh_hts25	Boolean
mh_hts26	Boolean
mh_hts27	Boolean
mh_hts28	Boolean
mh_hts29	Boolean
mh_hts30	Boolean
mh_hts31	Boolean
mh_hts32	Boolean
mh_hts33	Boolean
mh_hts34	Boolean
mh_hts35	Boolean
mh_hts_other	Boolean
mh_hts_other_details	Coded
_title_MH094	Title
comments	Coded
_title_MH096	Title
