_title_NUTITFC002	Title
encounter_location	Combo-encounter_location
admission_time	Time
_title_NUTITFC005	Title
_title_NUTITFC006	Title
itfc_phase2_date	Date
itfc_phase2_weight	Decimal-3
_title_NUTITFC009	Title
_title_NUTITFC010	Title
treatment_intensive_case_stay	Combo-treatment_intensive_case_stay
treatment_oxygen_therapy_yesno	Combo-treatment_oxygen_therapy_yesno
treatment_oxygen_therapy_hours	Decimal-1
treatment_antibiotherapy_yesno	Combo-treatment_antibiotherapy_yesno
treatment_antibiotherapy_days	Decimal-1
treatment_antimalaria_yesno	Combo-treatment_antimalaria_yesno
treatment_antimalaria_type	Combo-treatment_antimalaria_type
treatment_blood_transfusion_yesno	Combo-treatment_blood_transfusion_yesno
test_hemoglobin	Decimal-2
treatment_blood_transfusion_nb	Numeric
_title_NUTITFC021	Title
_title_NUTITFC022	Title
itfc_morbidity_main	Combo-itfc_morbidity_main
itfc_morbidity_main_other	Coded
itfc_morbidity_secondary_1	Combo-itfc_morbidity_secondary_1
itfc_morbidity_secondary_1_other_details	Coded
itfc_morbidity_secondary_2	Combo-itfc_morbidity_secondary_2
itfc_morbidity_secondary_2_other_details	Coded
itfc_morbidity_secondary_3	Combo-itfc_morbidity_secondary_3
itfc_morbidity_secondary_3_other_details	Coded
_title_NUTITFC031	Title
_title_NUTITFC032	Title
hiv_test_yesno	Combo-hiv_test_yesno
hiv_test_result	Combo-hiv_test_result
tb_test_yesno	Combo-tb_test_yesno
tb_test_result	Combo-tb_test_result
_title_NUTITFC037	Title
_title_NUTITFC038	Title
dicharge_date	Date
discharge_weight	Decimal-3
treatment_outcome_itfc	Combo-treatment_outcome_itfc
referral_external_place_1	Combo-referral_external_place_1
referral_external_cause_details	Coded
death_time	Time
death_cause	Combo-death_cause
death_cause_other_details	Coded
_title_NUTITFC047	Title
comments	Coded
_title_NUTITFC049	Title
