_title_PED002	Title
admission_time	Time
hospitalization_cause_details	Coded
_title_PED005	Title
_title_PED006	Title
admission_weight	Decimal-3
discharge_weight	Decimal-3
_title_PED009	Title
diagnosis_final_main	Combo-diagnosis_final_main
diagnosis_final_main_other	Coded
diagnosis_final_secondary_1	Combo-diagnosis_final_secondary_1
diagnosis_final_secondary_1_other_details	Coded
diagnosis_final_secondary_2	Combo-diagnosis_final_secondary_2
diagnosis_final_secondary_2_other_details	Coded
diagnosis_final_secondary_3	Combo-diagnosis_final_secondary_3
diagnosis_final_secondary_3_other_details	Coded
_title_PED018	Title
_title_PED019	Title
treatment_outcome	Combo-treatment_outcome
referral_external_place_1	Combo-referral_external_place_1
referral_external_cause_details	Coded
death_time	Time
death_cause	Combo-death_cause
death_cause_other_details	Coded
treatment_outcome_released_not_cured_details	Coded
_title_PED027	Title
_title_PED028	Title
treatment_intensive_case_stay	Combo-treatment_intensive_case_stay
treatment_oxygen_therapy_yesno	Combo-treatment_oxygen_therapy_yesno
treatment_oxygen_therapy_hours	Decimal-1
treatment_antibiotherapy_yesno	Combo-treatment_antibiotherapy_yesno
treatment_antibiotherapy_days	Decimal-1
treatment_antimalaria_yesno	Combo-treatment_antimalaria_yesno
treatment_antimalaria_type	Combo-treatment_antimalaria_type
treatment_blood_transfusion_yesno	Combo-treatment_blood_transfusion_yesno
test_hemoglobin	Decimal-2
treatment_blood_transfusion_nb	Numeric
_title_PED039	Title
_title_PED040	Title
hiv_test_yesno	Combo-hiv_test_yesno
hiv_test_result	Combo-hiv_test_result
tb_test_yesno	Combo-tb_test_yesno
tb_test_result	Combo-tb_test_result
_title_PED045	Title
comments	Coded
_title_PED047	Title
