_title_NUTITFC002	Title
encounter_location	Combo-encounter_location
admission_weight	Decimal-3
_title_NUTITFC005	Title
_title_NUTITFC006	Title
atfc_morbidity_main	Combo-atfc_morbidity_main
atfc_morbidity_main_other	Coded
atfc_morbidity_secondary_1	Combo-atfc_morbidity_secondary_1
atfc_morbidity_secondary_1_other_details	Coded
atfc_morbidity_secondary_2	Combo-atfc_morbidity_secondary_2
atfc_morbidity_secondary_2_other_details	Coded
atfc_morbidity_secondary_3	Combo-atfc_morbidity_secondary_3
atfc_morbidity_secondary_3_other_details	Coded
_title_NUTITFC015	Title
_title_NUTITFC016	Title
dicharge_date	Date
discharge_weight	Decimal-3
treatment_outcome_atfc	Combo-treatment_outcome_atfc
death_date_estimated	Date
death_cause_other_details	Coded
_title_NUTITFC022	Title
comments	Coded
_title_NUTITFC024	Title
