_title_NLHGE002	Title
er_triage_color_code	Combo-er_triage_color_code
admission_transit_method	Combo-admission_transit_method
admission_transit_method_other_details	Coded
referred_by	Combo-referred_by
_title_NLHGE007	Title
_title_NLHGE008	Title
er_time_decision_to_arrival	Combo-er_time_decision_to_arrival
er_triage_time	Time
_title_MH011	Title
er_triage_impression_affected	Combo-er_triage_impression_affected
_title_MH013	Title
_title_MH014	Title
er_consultation_time	Time
_title_MH016	Title
_title_MH017	Title
treatment_immobilization	Boolean
treatment_dressing	Boolean
treatment_sutures	Boolean
treatment_monitor_cardiac	Boolean
treatment_chest_tube	Boolean
treatment_ett	Boolean
treatment_urinary_catheter	Boolean
treatment_cpr	Boolean
treatment_blood_transfusion	Boolean
treatment_ngog	Boolean
treatment_other	Boolean
treatment_other_details	Coded
_title_MH030	Title
_title_MH031	Title
test_blood_chemistry_done	Boolean
test_blood_typing_done	Boolean
test_blood_glucose_done	Boolean
test_ct_scan_done	Boolean
test_cbc_done	Boolean
test_pregnancy_test_done	Boolean
test_lumbar_puncture_done	Boolean
test_urinalysis_done	Boolean
test_cardiac_enzymes_done	Boolean
test_blood_urine_done	Boolean
test_ecg_done	Boolean
test_xray_done	Boolean
hiv_test_done	Boolean
test_other_done	Boolean
test_other_done_details	Coded
_title_MH047	Title
_title_MH048	Title
treatment_oxygen_therapy_done	Boolean
treatment_oral_antibiotics_done	Boolean
treatment_tetanus_vaccine_done	Boolean
treatment_medication_via_nebulizer_done	Boolean
treatment_parenteral_antibiotics_done	Boolean
treatment_parenterial_antihypertensives_done	Boolean
treatment_antianginal_medications_done	Boolean
treatment_thrombolytics_done	Boolean
treatment_antiarrhythmics_done	Boolean
treatment_pep_done	Boolean
treatment_corticosteroids_done	Boolean
treatment_oral_analgesics_done	Boolean
treatment_parenteral_analgesics_done	Boolean
treatment_antiplatelets_done	Boolean
treatment_other_done	Boolean
treatment_other_done_details	Coded
_title_MH065	Title
er_outcome_death	Combo-er_outcome_death
death_cause	Combo-death_cause
death_cause_other	Coded
er_outcome_death_comments	Coded
_title_MH070	Title
er_injury	Combo-er_injury
er_injury_cause	Combo-er_injury_cause
er_injury_cause_other_detail	Coded
er_injury_location	Combo-er_injury_location
_title_MH075	Title
burn_bsa	Numeric
burn_area_critical	Combo-burn_area_critical
_title_MH078	Title
_title_MH079	Title
er_discharge_time	Time
er_discharge_date	Date
er_outcome	Combo-er_outcome
er_referred_to_unit	Combo-er_referred_to_unit
_title_MH084	Title
comments	Coded
_title_MH086	Title
