_title_sur_01	Title
sur_emergency_type	Combo-sur_emergency_type
sur_cause_trauma	Boolean
sur_cause_trauma_type	Combo-sur_cause_trauma_type
sur_cause_trauma_type_other	Coded
sur_cause_non_trauma	Boolean
sur_cause_pathology	Combo-sur_cause_pathology
sur_cause_pathology_other	Coded
sur_cause_pathology	Combo-sur_cause_pathology
sur_cause_pathology_other	Boolean
_title_sur_02	Title
_title_sur_03	Title
sur_intervention_main_type	Combo-sur_intervention_main_type
sur_intervention_main_date	Date
sur_intervention_main_asa	Combo-sur_intervention_main_asa
sur_intervention_main_anesthesia	Combo-sur_intervention_main_anesthesia
sur_intervention_main_transfusion_nb	Numeric
sur_intervention_main_transfusion_volume	Numeric
sur_intervention_main_fixator_internal	Boolean
sur_intervention_main_fixator_external	Boolean
sur_intervention_main_plaster	Boolean
sur_intervention_main_thoracic_drain	Boolean
_title_sur_04	Title
_title_sur_05	Title
sur_intervention_2_type	Combo-sur_intervention_2_type
sur_intervention_2_date	Date
sur_intervention_2_plan	Combo-sur_intervention_2_plan
sur_intervention_2_asa	Combo-sur_intervention_2_asa
sur_intervention_2_anesthesia	Combo-sur_intervention_2_anesthesia
sur_intervention_2_transfusion_nb	Numeric
sur_intervention_2_transfusion_volume	Numeric
sur_intervention_2_fixator_internal	Boolean
sur_intervention_2_fixator_external	Boolean
sur_intervention_2_plaster	Boolean
sur_intervention_2_thoracic_drain	Boolean
_title_sur_06	Title
_title_sur_07	Title
sur_intervention_3_type	Combo-sur_intervention_3_type
sur_intervention_3_date	Date
sur_intervention_3_plan	Combo-sur_intervention_3_plan
sur_intervention_3_asa	Combo-sur_intervention_3_asa
sur_intervention_3_anesthesia	Combo-sur_intervention_3_anesthesia
sur_intervention_3_transfusion_nb	Numeric
sur_intervention_3_transfusion_volume	Numeric
sur_intervention_3_fixator_internal	Boolean
sur_intervention_3_fixator_external	Boolean
sur_intervention_3_plaster	Boolean
sur_intervention_3_thoracic_drain	Boolean
_title_sur_08	Title
_title_sur_09	Title
sur_post_treatment_antibiotherapy_24h	Combo-sur_post_treatment_antibiotherapy_24h
sur_post_treatment_anticoagulant	Combo-sur_post_treatment_anticoagulant
sur_post_treatment_morphine_24h	Combo-sur_post_treatment_morphine_24h
sur_post_treatment_morphino_mimetica_24h	Combo-sur_post_treatment_morphino_mimetica_24h
sur_post_treatment_physiotherapy	Combo-sur_post_treatment_physiotherapy
sur_post_treatment_transfusion_nb	Numeric
sur_post_treatment_transfusion_volume	Numeric
_title_sur_10	Title
_title_sur_11	Title
sur_complication_bleeding_200ml	Boolean
surgical_site_infection	Combo-surgical_site_infection
