_title_med_01	Title
_title_med_02	Title
antecedents_htn	Boolean
antecedents_diabetes	Boolean
antecedents_cva	Boolean
antecedents_hiv	Boolean
antecedents_tb	Boolean
antecedents_med_edical_specify	Coded
_title_med_03	Title
antecedents_csection	Boolean
antecedents_surgical_other	Coded
_title_med_04	Title
antecedents_gestity	Numeric
antecedents_parity	Numeric
_title_med_05	Title
antecedents_chronic_treatment_specify	Coded
_title_med_06	Title
_title_med_07	Title
medicine_emergency	Combo-medicine_emergency
_title_med_08	Title
coma	Boolean
abp_diastolic	Numeric
abp_systolic	Numeric
pulse	Numeric
respiratory_rate	Numeric
temperature	Numeric
_title_med_09	Title
hemoglobin_gdl	Numeric
glycaemia	Numeric
proteinuria	Numeric
creatinine	Numeric
_title_med_10	Title
_title_med_11	Title
treatment_oxygen_therapy	Combo-treatment_oxygen_therapy
treatment_oxygen_therapy_duration	Time
treatment_antibiotherapy_line1	Boolean
treatment_antibiotherapy_line2	Boolean
treatment_antibiotherapy_duration	Numeric
treatment_blood_transfusion	Boolean
treatment_blood_transfusion_bags_nb	Numeric
treatment_antitb	Boolean
treatment_antiemetics	Boolean
treatment_rehydration_2000mld	Boolean
treatment_antihtn	Boolean
treatment_vasodilatator	Boolean
treatment_anticoagulant	Boolean
treatment_insulin	Boolean
treatment_antidiabetes_oral	Boolean
treatment_antiinflamatory	Boolean
treatment_morphinomimetica	Boolean
treatment_physiotherapy_resp	Boolean
treatment_physiotherapy	Boolean
treatment_phsychotherapy	Boolean
treatment_other1	Coded
treatment_other2	Coded
treatment_other3	Coded
_title_med_12	Title
_title_med_13	Title
complication_rti	Boolean
complication_diabetic_decompensation	Boolean
complication_hypertensive_crisis	Boolean
complication_cardiac_ecompensation	Boolean
complication_coma	Boolean
complication_renal_insufficiency	Boolean
complication_hepatic_insufficiency	Boolean
complication_other1	Coded
complication_other2	Coded
complication_other3	Coded
