_title_SGBV03_01	Title
encounter_location	Combo-encounter_location
consultation_mental_health_provider	Combo-consultation_mental_health_provider
referred_by	Combo-referred_by
_title_SGBV03_02	Title
_title_SGBV03_03	Title
encounter_motive	Combo-encounter_motive
trauma_event_main	Combo-trauma_event_main
trauma_event_date	Date
care_delay	Combo-care_delay
complaint_main	Coded
diagnosis_psychiatric_impression	Combo-diagnosis_psychiatric_impression
diagnosis_psychiatric	Combo-diagnosis_psychiatric
_title_SGBV03_04	Title
_title_SGBV03_05	Title
pfa_done	Combo-pfa_done
pfa_provider	Combo-pfa_provider
intervention_psycho_type	Combo-intervention_psycho_type
antecedents_psychiatric	Combo-antecedents_psychiatric
medication_psychiatric_1	Combo-medication_psychiatric_1
medication_psychiatric_2	Combo-medication_psychiatric_2
medication_psychiatric_3	Combo-medication_psychiatric_3
_title_SGBV03_06	Title
_title_SGBV03_07	Title
referral_psycho	Combo-referral_psycho
outcome_psycho	Combo-outcome_psycho
gaf	Numeric
srq20	Numeric
_title_SGBV03_08	Title
comments	Coded
_title_SGBV03_09	Title
