_title_SGBV02_01	Title
encounter_location	Combo-encounter_location
encounter_number	Numeric
consultation_provider	Combo-consultation_provider
certificate_medical_given	Combo-certificate_medical_given
_title_SGBV02_02	Title
_title_SGBV02_03	Title
abortion_request	Combo-abortion_request
abortion_done	Combo-abortion_done
pep_done	Combo-pep_done
_title_SGBV02_04	Title
_title_SGBV02_05	Title
vaccination_hepatitisb1	Combo-vaccination_hepatitisb1
vaccination_hepatitisb2	Combo-vaccination_hepatitisb2
vaccination_hepatitisb3	Combo-vaccination_hepatitisb3
vaccination_hepatitisb_booster	Combo-vaccination_hepatitisb_booster
vaccination_tetanus1	Combo-vaccination_tetanus1
vaccination_tetanus2	Combo-vaccination_tetanus2
vaccination_tetanus3	Combo-vaccination_tetanus3
vaccination_tetanus4	Combo-vaccination_tetanus4
vaccination_tetanus5	Combo-vaccination_tetanus5
vaccination_tetanus_booster	Combo-vaccination_tetanus_booster
_title_SGBV02_06	Title
_title_SGBV02_07	Title
pregnancy_test	Combo-pregnancy_test
hiv_test_first	Combo-hiv_test_first
hiv_test_second	Combo-hiv_test_second
hiv_test_3months	Combo-hiv_test_3months
hiv_test_3months_second	Combo-hiv_test_3months_second
hiv_test_6months	Combo-hiv_test_6months
hiv_test_6months_second	Combo-hiv_test_6months_second
family_planning	Combo-family_planning
_title_SGBV02_08	Title
comments	Coded
_title_SGBV02_09	Title
