_title_SGBV04_01	Title
encounter_location	Combo-encounter_location
encounter_number	Numeric
consultation_mental_health_provider	Combo-consultation_mental_health_provider
intervention_psycho_type	Combo-intervention_psycho_type
_title_SGBV04_02	Title
_title_SGBV04_03	Title
antecedents_psychiatric	Combo-antecedents_psychiatric
medication_psychiatric_1	Combo-medication_psychiatric_1
medication_psychiatric_2	Combo-medication_psychiatric_2
medication_psychiatric_3	Combo-medication_psychiatric_3
_title_SGBV04_04	Title
_title_SGBV04_05	Title
referral_psycho	Combo-referral_psycho
outcome_psycho	Combo-outcome_psycho
gaf	Numeric
srq20	Numeric
_title_SGBV04_06	Title
comments	Coded
_title_SGBV04_07	Title
