_title_YFIPD002	Title
referred_in	Combo-referred_in
_title_YFIPD004	Title
_title_YFIPD005	Title
other_cases_family	Combo-other_cases_family
other_cases_origin	Combo-other_cases_origin
onset_date	Date
vaccination_history_yf	Combo-vaccination_history_yf
jaundice_history	Combo-jaundice_history
_title_YFIPD011	Title
_title_YFIPD012	Title
symptom_unconscious	Boolean
symptom_fever	Boolean
symptom_headache	Boolean
symptom_weakness	Boolean
symptom_muscular_pain	Boolean
symptom_joint_pain	Boolean
symptom_hiccup	Boolean
symptom_anorexia	Boolean
symptom_nausea	Boolean
symptom_vomiting	Boolean
symptom_sore_throat	Boolean
symptom_abdominal_pain	Boolean
symptom_abdomen_tender	Boolean
symptom_ruq_pain	Boolean
symptom_diarrhoea	Boolean
symptom_oliguria_anuria	Boolean
symptom_dyspnoea	Boolean
symptom_cough	Boolean
symptom_chest_paine	Boolean
symptom_backache	Boolean
symptom_jaundice	Boolean
symptom_rash_non_haemor	Boolean
symptom_hepatomegaly	Boolean
symptom_splenomegaly	Boolean
symptom_dehydration	Boolean
symptom_anemia_clinical	Boolean
symptom_delirium	Boolean
symptom_convulsions	Boolean
symptom_coma	Boolean
symptom_shock	Boolean
symptom_dark_tip_tongue	Boolean
symptom_oedema_face_conjunctivae	Boolean
symptom_injected_haemorrhage_eyes	Boolean
symptom_epistaxis	Boolean
symptom_gingival_bleeding	Boolean
symptom_haemoptysis	Boolean
symptom_haemotemesis	Boolean
symptom_melena	Boolean
symptom_hematuria	Boolean
symptom_vaginal_bleeding_non_menstrual	Boolean
symptom_bleeding_injection_site	Boolean
symptom_petechia_purpura	Boolean
symptom_hypovolemic_shock	Boolean
symptom_hypoglycemia	Boolean
symptom_hypothermia	Boolean
symptom_other	Coded
_title_YFIPD059	Title
_title_YFIPD060	Title
case_classification_yf	Combo-case_classification_yf
severity	Combo-severity
_title_YFIPD063	Title
complication1	Combo-complication1
complication2	Combo-complication2
complication3	Combo-complication3
comorbidity	Coded
_title_YFIPD068	Title
diagnosis_no_yf	Coded
_title_YFIPD070	Title
_title_YFIPD071	Title
treatment_outcome	Combo-treatment_outcome
discharge_date	Date
_title_YFIPD074	Title
_title_YFIPD075	Title
test_blood_igm	Combo-test_blood_igm
test_blood_igg_acute	Combo-test_blood_igg_acute
test_blood_igg_convalescent	Combo-test_blood_igg_convalescent
test_pcr_yellow_fever	Combo-test_pcr_yellow_fever
_title_YFIPD080	Title
test_hepatitis_a	Combo-test_hepatitis_a
test_hepatitis_b	Combo-test_hepatitis_b
test_hepatitis_c	Combo-test_hepatitis_c
test_hepatitis_d	Combo-test_hepatitis_d
test_hepatitis_e	Combo-test_hepatitis_e
_title_YFIPD086	Title
rdt_malaria	Combo-rdt_malaria
test_malaria_slide	Combo-test_malaria_slide
_title_YFIPD089	Title
test_urine_proteinuria	Combo-test_urine_proteinuria
test_urine_bilirubinuria	Combo-test_urine_bilirubinuria
test_urine_hematuria	Combo-test_urine_hematuria
test_urine_glucosuria	Combo-test_urine_glucosuria
test_urine_wbc	Combo-test_urine_wbc
_title_YFIPD095	Title
test_blood_hb	Numeric
test_blood_leucocytes	Numeric
test_blood_thrombocytes	Numeric
test_blood_glucose	Numeric
test_coagulation_pt	Numeric
_title_YFIPD101	Title
test_biochem_na	Numeric
test_biochem_k	Numeric
test_biochem_nh	Numeric
test_biochem_bicarbonate	Numeric
_title_YFIPD106	Title
test_liver_asat	Numeric
test_liver_alat	Numeric
test_liver_alp	Numeric
test_liver_bilirubine	Numeric
_title_YFIPD111	Title
test_kidney_urea	Numeric
test_kidney_creatinine	Numeric
test_urine_dipstick	Combo-test_urine_dipstick
test_glycaemia	Combo-test_glycaemia
_title_YFIPD116	Title
test_other_type	Coded
test_other_result	Coded
_title_YFIPD119	Title
specimens_sent_to_labo	Combo-specimens_sent_to_labo
_title_YFIPD121	Title
comments	Coded
_title_YFIPD123	Title
