_title_EpidOPD002	Title
malaria_case	Boolean
measles_case	Boolean
yfever_susp_case	Boolean
meningitis_sups_case	Boolean
_title_EpidOPD007	Title
_title_EpidOPD008	Title
muac	Combo-muac
oedema	Combo-oedema
_title_EpidOPD011	Title
_title_EpidOPD012	Title
vaccinal_status_measles	Combo-vaccinal_status_measles
vaccinal_status_measles_card	Combo-vaccinal_status_measles_card
_title_EpidOPD015	Title
_title_EpidOPD016	Title
rdt_malaria	Combo-rdt_malaria
malaria_severity	Combo-malaria_severity
_title_EpidOPD019	Title
_title_EpidOPD020	Title
referred_out	Combo-referred_out
_title_EpidOPD022	Title
comments	Coded
_title_EpidOPD024	Title
