_title_cholera_01	Title
diagnosis_date	Date
referred_in	Combo-referred_in
_title_cholera_02	Title
_title_cholera_03	Title
rdt_cholera	Combo-rdt_cholera
cholera_plan	Combo-cholera_plan
comorbidity_cholera_1	Combo-comorbidity_cholera_1
comorbidity_cholera_2	Combo-comorbidity_cholera_2
comorbidity_cholera_other	Coded
_title_cholera_04	Title
_title_cholera_05	Title
vaccinal_status_cholera_doses	Numeric
vaccinal_status_cholera_last_date	Date
vaccinal_status_cholera_card	Combo-vaccinal_status_cholera_card
_title_cholera_08	Title
_title_cholera_09	Title
discharge_date	Date
treatment_outcome	Combo-treatment_outcome
death_cause	Combo-death_cause
death_cause_other	Coded
comments	Coded
