_title_hivfup_01	Title
hiv_fup_consultation_on_time	Combo-hiv_fup_consultation_on_time
hiv_fup_no_change	Boolean
weight_kg	Decimal-3
_title_hivfup_02	Title
_title_hivfup_03	Title
haemoglobin_g_dl	Numeric
creatinine_clearance	Numeric
cd4	Numeric
lab_analysis_other	Coded
_title_hivfup_04	Title
_title_hivfup_05	Title
hiv_oi_new_stage	Combo-hiv_oi_new_stage
hiv_tb_coinfection_new	Boolean
hiv_intercurrent_condition_severe	Coded
hiv_drug_side_effect	Coded
_title_hivfup_06	Title
_title_hivfup_07	Title
hiv_arv_regimen_1	Combo-hiv_arv_regimen_1
hiv_arv_event_1	Combo-hiv_arv_event_1
hiv_arv_regimen_2	Combo-hiv_arv_regimen_2
hiv_arv_event_2	Combo-hiv_arv_event_2
tb_treatment_category_1	Combo-tb_treatment_category_1
tb_treatment_event_1	Combo-tb_treatment_event_1
tb_treatment_category_2	Combo-tb_treatment_category_2
tb_treatment_event_2	Combo-tb_treatment_event_2
prophylaxis_ipt	Combo-prophylaxis_ipt
prophylaxis_cotrimoxazole	Combo-prophylaxis_cotrimoxazole
rutf_rusf	Combo-rutf_rusf
_title_hivfup_08	Title
_title_hivfup_09	Title
observance_problem	Boolean
appointment_next_date	Date
comments	Coded
