_title_01	Title
tb_treatment_category	Combo-tb_treatment_category
tb_case_definition	Combo-tb_case_definition
tb_patient_type	Combo-tb_patient_type
tb_exam_period	Combo-tb_exam_period
weight_kg	Decimal-3
tb_smear_result_direct	Combo-tb_smear_result_direct
tb_smear_date	Date
tb_smear_id	Coded
tb_culture_result	Combo-tb_culture_result
tb_culture_date	Date
tb_culture_id	Coded
tb_treatment_outcome	Combo-tb_treatment_outcome
tb_treatment_outcome_date	Date
_title_02	Title
_title_03	Title
tb_hiv_test_result	Combo-tb_hiv_test_result
tb_hiv_test_date	Date
tb_art_test_result	Combo-tb_art_test_result
tb_art_test_date	Date
tb_cpt_test_result	Combo-tb_cpt_test_result
tb_cpt_test_date	Date
_title_04	Title
_title_05	Title
appointment_next_date	Date
comments	Coded
