_title_NCDE1002	Title
_title_NCDE1003	Title
_title_NCDE1004	Title
diagnosis_hbp	Combo-diagnosis_hbp
diagnosis_hbp_pregnancy_induced	Combo-diagnosis_hbp_pregnancy_induced
diagnosis_diabetes1	Combo-diagnosis_diabetes1
diagnosis_diabetes2	Combo-diagnosis_diabetes2
diagnosis_hypothyroidism	Combo-diagnosis_hypothyroidism
diagnosis_copd_asthma	Combo-diagnosis_copd_asthma
diagnosis_cardiovascular_disorder	Combo-diagnosis_cardiovascular_disorder
diagnosis_heart_failure	Combo-diagnosis_heart_failure
diagnosis_epilepsy	Combo-diagnosis_epilepsy
_title_NCDE1014	Title
_title_NCDE1015	Title
_title_NCDE1016	Title
antecedents_angina_pectoris	Boolean
antecedents_myocardial_infarction	Boolean
antecedents_cabg	Boolean
antecedents_angioplasty	Boolean
_title_NCDE1021	Title
antecedents_cva	Boolean
antecedents_carotid_endarterectomy	Boolean
_title_NCDE1024	Title
antecedents_claudication	Boolean
antecedents_ischaemic_ulcer_amputation	Boolean
_title_NCDE1027	Title
_title_NCDE1028	Title
antecedents_heart_failure	Boolean
antecedents_left_ventricular_hypertrophy	Boolean
antecedents_retinopathy	Boolean
antecedents_renal_failure	Boolean
antecedents_diabetes_renal_impairment	Boolean
antecedents_hypertension_renal_impairment	Boolean
_title_NCDE1035	Title
_title_NCDE1036	Title
risk_score_cv_with_cholesterol	Combo-risk_score_cv_with_cholesterol
risk_score_cv_without_cholesterol	Combo-risk_score_cv_without_cholesterol
_title_NCDE1039	Title
_title_NCDE1040	Title
weight_kg	Numeric
height_m	Decimal-2
abp_diastolic	Numeric
abp_systolic	Numeric
blood_glucose	Decimal-2
_title_NCDE1046	Title
_title_NCDE1047	Title
treatment_current_name_01	Combo-treatment_current_name_01
treatment_current_name_01_perday	Decimal-1
treatment_current_name_02	Combo-treatment_current_name_02
treatment_current_name_02_perday	Decimal-1
treatment_current_name_03	Combo-treatment_current_name_03
treatment_current_name_03_perday	Decimal-1
treatment_current_name_04	Combo-treatment_current_name_04
treatment_current_name_04_perday	Decimal-1
treatment_current_name_05	Combo-treatment_current_name_05
treatment_current_name_05_perday	Decimal-1
treatment_current_name_06	Combo-treatment_current_name_06
treatment_current_name_06_perday	Decimal-1
treatment_current_name_07	Combo-treatment_current_name_07
treatment_current_name_07_perday	Decimal-1
treatment_current_name_08	Combo-treatment_current_name_08
treatment_current_name_08_perday	Decimal-1
treatment_current_name_09	Combo-treatment_current_name_09
treatment_current_name_09_perday	Decimal-1
treatment_current_name_10	Combo-treatment_current_name_10
treatment_current_name_10_perday	Decimal-1
treatment_current_name_other	Coded
treatment_current_name_other_perday	Decimal-1
_title_NCDE1070	Title
_title_NCDE1071	Title
ncd_patient_education_by	Combo-ncd_patient_education_by
_title_NCDE1073	Title
_title_NCDE1074	Title
test_required_ecg	Boolean
test_required_echo	Boolean
_title_NCDE1077	Title
test_required_hba1c	Boolean
test_required_cholesterol_total	Boolean
test_required_creatinine	Boolean
test_required_urine_analysis	Boolean
test_required_urine_microalbumin	Boolean
_title_NCDE1083	Title
test_required_alt	Boolean
test_required_k	Boolean
test_required_tsh	Boolean
test_required_inr	Boolean
test_required_ldl	Boolean
_title_NCDE1089	Title
test_required_other	Coded
_title_NCDE1091	Title
_title_NCDE1092	Title
referral_out_er	Boolean
referral_out_surgery	Boolean
referral_out_social_worker	Boolean
referral_out_other_ngo	Boolean
_title_NCDE1097	Title
referral_out_cardiologist	Boolean
referral_out_endocrinologist	Boolean
referral_out_ophthalmologist	Boolean
referral_out_neurologist	Boolean
referral_out_nephrologist	Boolean
referral_out_specialist_other	Coded
_title_NCDE1104	Title
_title_NCDE1105	Title
appointment_next_date	Date
_title_NCDE1107	Title
comments	Coded
_title_NCDE1109	Title