_title_00E	Title
birth_place_type	Combo-birth_place_type
birth_type	Combo-birth_type
birth_time	Time
birth_weight	Decimal-3
gestational_age	Numeric
skull_perimeter	Numeric
iugr	Combo-iugr
twinning	Combo-twinning
_title_01E	Title
apgar_score_1minute	Numeric
apgar_score_5minutes	Numeric
apgar_score_10minutes	Numeric
amniotic_liquid_color	Combo-amniotic_liquid_color
_title_02E	Title
resuscitation_method_ventilation	Combo-resuscitation_method_ventilation
resuscitation_method_heart_massage	Combo-resuscitation_method_heart_massage
resuscitation_method_drug	Combo-resuscitation_method_drug
_title_03E	Title
maternal_infectious_risk_fever	Boolean
maternal_infectious_risk_chorioamniotitis	Boolean
maternal_infectious_risk_prom	Boolean
eclampsia_preeclampsia	Combo-eclampsia_preeclampsia
maternal_death	Combo-maternal_death
maternal_death_cause	Combo-maternal_death_cause
maternal_death_cause_other	Coded
_title_04E	Title
_title_05E	Title
admission_place	Combo-admission_place
kangaroo_unit_stay	Combo-kangaroo_unit_stay
neonatology_unit_stay	Combo-neonatology_unit_stay
_title_06E	Title
neonate_feeding_perfusion	Boolean
neonate_feeding_ogng	Boolean
neonate_feeding_po	Boolean
_title_07E	Title
milk_mother	Boolean
milk_formula	Boolean
milk_other	Boolean
_title_08E	Title
treatment_blood_transfusion	Combo-treatment_blood_transfusion
treatment_oxygen_therapy	Boolean
treatment_surgery	Boolean
treatment_antibiotherapy_line1	Boolean
treatment_antibiotherapy_line2	Boolean
treatment_pmtct	Boolean
treatment_phototherapy	Boolean
treatment_warming_lamp	Boolean
treatment_cafein	Boolean
treatment_phenobarbital	Boolean
treatment_rehydration_bolus_10ml	Combo-treatment_rehydration_bolus_10ml
treatment_artesunate	Boolean
treatment_asaq_coartem	Boolean
_title_09E	Title
vaccination_afp0	Boolean
vaccination_bcg	Boolean
vaccination_hepb0	Boolean
_title_10E	Title
mother_vaccination_tt1	Boolean
mother_vaccination_tt2	Boolean
mother_vaccination_tt3	Boolean
mother_vaccination_tt4	Boolean
mother_vaccination_tt5	Boolean
discharge_neurologic_status_normal	Combo-discharge_neurologic_status_normal
neonatology_death_moment	Combo-neonatology_death_moment
comments	Coded
