_title_ped_01	Title
neo_mother_alive	Combo-neo_mother_alive
neo_mother_malnurished	Combo-neo_mother_malnurished
neo_mother_hiv_positive	Combo-neo_mother_hiv_positive
neo_mother_tb_positive	Combo-neo_mother_tb_positive
_title_ped_02	Title
neo_mother_vacci_tt1	Boolean
neo_mother_vacci_tt2	Boolean
neo_mother_vacci_tt3	Boolean
neo_mother_vacci_tt4	Boolean
neo_mother_vacci_tt5	Boolean
_title_ped_03	Title
_title_ped_04	Title
admission_weight	Decimal-3
nutritionnal_status	Combo-nutritionnal_status
_title_ped_05	Title
_title_ped_06	Title
vaccination_dtc	Combo-vaccination_dtc
vaccination_pentavalent	Combo-vaccination_pentavalent
vaccination_afp	Combo-vaccination_afp
vaccination_measles	Combo-vaccination_measles
vaccination_pcv13	Combo-vaccination_pcv13
_title_ped_07	Title
_title_ped_08	Title
stay_intensive_care	Boolean
_title_ped_09	Title
ped_feeding	Combo-ped_feeding
ped_feeding_f75_f100	Boolean
ped_feeding_rutf	Boolean
ped_feeding_rusf	Boolean
ped_feeding_standard_regimen	Boolean
_title_ped_10	Title
_title_ped_11	Title
treatment_albendazole	Boolean
treatment_vitamin_a	Boolean
treatment_ventil_ambu	Boolean
treatment_adrenaline	Boolean
treatment_rehydration_bolus_15_20ml	Combo-treatment_rehydration_bolus_15_20ml
treatment_blood_transfusion	Combo-treatment_blood_transfusion
treatment_oxygen_therapy	Boolean
treatment_ors_resomal	Boolean
treatment_surgery	Boolean
treatment_cast	Boolean
treatment_io	Boolean
treatment_lp	Boolean
treatment_thoracic_drainage	Boolean
treatment_antibiotherapy_line1	Boolean
treatment_antibiotherapy_line2	Boolean
treatment_antibiotherapy_line3	Boolean
treatment_antitb	Boolean
treatment_inh	Boolean
treatment_arv	Boolean
treatment_corticosteroids	Boolean
treatment_diazepam	Boolean
treatment_phenobarbital	Boolean
treatment_phenytoin	Boolean
treatment_salbutamol	Boolean
treatment_ketamine	Boolean
treatment_morphine	Boolean
treatment_artesunate	Boolean
treatment_asaq_coartem	Boolean
_title_ped_12	Title
_title_ped_13	Title
discharge_weight	Decimal-3
discharge_sequelae	Boolean
comments	Coded
