_title_del_01	Title
antecedents_htn	Boolean
antecedents_diabetes	Boolean
antecedents_hiv	Boolean
antecedents_tb	Boolean
antecedents_medical_other	Coded
_title_del_02	Title
antecedents_csection	Boolean
antecedents_surgical_other	Coded
_title_del_03	Title
antecedents_gestity	Numeric
antecedents_parity	Numeric
antecedents_children_born_living_nb	Numeric
antecedents_stillbirth_nb	Numeric
antecedents_misscarriage_nb	Numeric
antecedents_abortion_nb	Numeric
antecedents_children_living_nb	Numeric
_title_del_04	Title
_title_del_05	Title
anc_nb	Numeric
pregnancy_normal	Boolean
pregnancy_hospitalisation	Boolean
pregnancy_hiv_test	Combo-pregnancy_hiv_test
_title_del_06	Title
pregnancy_htn	Boolean
pregnancy_preeclampsia	Boolean
pregnancy_eclampsia	Boolean
pregnancy_uc_pbr	Boolean
pregnancy_infection	Boolean
pregnancy_placenta_praevia	Boolean
pregnancy_iufd	Boolean
pregnancy_pathology_other	Coded
_title_del_07	Title
pregnancy_treatment_anti_htn	Boolean
pregnancy_treatment_mg_sulfate	Boolean
pregnancy_treatment_corticosteroids	Boolean
pregnancy_treatment_antibiotics	Boolean
pregnancy_treatment_aspirin	Boolean
pregnancy_treatment_pmtct	Boolean
pregnancy_treatment_other	Coded
_title_del_08	Title
_title_del_09	Title
pregnancy_weeks	Numeric
_title_del_10	Title
admission_cause_spontaneous_labour	Boolean
admission_cause_rom	Boolean
admission_cause_bleeding	Boolean
admission_cause_pathologic_pregnancy	Boolean
_title_del_11	Title
admission_exam_htn	Boolean
admission_exam_htn_clinical	Boolean
admission_exam_proteinuria	Boolean
admission_exam_fever	Boolean
admission_exam_rph	Boolean
admission_exam_convulsions	Boolean
_title_del_12	Title
admission_treatment_anti_htn	Boolean
admission_treatment_mg_sulfate	Boolean
admission_treatment_corticosteroids	Boolean
admission_treatment_antibiotics	Boolean
admission_treatment_aspirin	Boolean
admission_treatment_other	Coded
_title_del_13	Title
admission_foetus_presentation	Combo-admission_foetus_presentation
dilatation	Numeric
foetus_heart_noise_perceived	Boolean
twin_pregnancy	Boolean
amniotic_sac_membrane	Combo-amniotic_sac_membrane
amniotic_sac_membrane_spontaneous_rupture	Combo-amniotic_sac_membrane_spontaneous_rupture
amniotic_liquid_admission	Combo-amniotic_liquid_admission
_title_del_14	Title
_title_del_15	Title
delivery_by	Combo-delivery_by
delivery_fundal_heigth	Numeric
labour_spontaneous	Combo-labour_spontaneous
foetus_presentation	Combo-foetus_presentation
delivery_multiple	Combo-delivery_multiple
foetal_suffering	Boolean
cord_prolapse	Boolean
cord_circulair	Boolean
amniotic_liquid	Combo-amniotic_liquid
amniotic_liquid_admission_small_amount	Boolean
partogram_used	Boolean
_title_del_16	Title
labour_treatment_oxytocin	Boolean
labour_treatment_anti_htn	Boolean
labour_treatment_antibiotics	Boolean
labour_treatment_mg_sulfate	Boolean
labour_treatment_other	Coded
_title_del_17	Title
delivery_type	Combo-delivery_type
delivery_vaginal	Boolean
delivery_labors_vacuum	Boolean
delivery_labors_forceps	Boolean
_title_del_18	Title
delivery_foetal_distress	Boolean
delivery_prolapsed_cord	Boolean
delivery_circular_cord	Boolean
delivery_meconium	Boolean
delivery_shoulder_dystocia	Boolean
delivery_perineum_tear	Boolean
delivery_cervix_tear	Boolean
delivery_incomplete_placenta	Boolean
delivery_preeclampsia	Boolean
delivery_eclampsia	Boolean
delivery_bleeding	Boolean
_title_del_19	Title
_title_del_20	Title
csection_type	Combo-csection_type
csection_by	Combo-csection_by
_title_del_21	Title
csection_indication_labour	Boolean
csection_indication_foetal_distress	Boolean
csection_indication_preeclampsia	Boolean
csection_indication_eclampsia	Boolean
csection_indication_placenta_praevia	Boolean
csection_indication_rph	Boolean
anesthesia_type	Combo-anesthesia_type
perinea	Combo-perinea
cervical_tear	Boolean
episiotomy	Boolean
delivery_spontaneous	Combo-delivery_spontaneous
delivery_complete	Combo-delivery_complete
delivery_haemorrhage	Boolean
treatment_uterine_massage	Boolean
treatment_transfusion	Boolean
treatment_bakri_balloon	Boolean
treatment_maternal_resuscitation	Boolean
_title_del_22	Title
_title_del_23	Title
newborn_status	Combo-newborn_status
newborn_status_child2	Combo-newborn_status_child2
newborn_status_child3	Combo-newborn_status_child3
newborn_term	Combo-newborn_term
newborn_term_child2	Combo-newborn_term_child2
newborn_term_child3	Combo-newborn_term_child3
newborn_sex	Combo-newborn_sex
newborn_sex_child2	Combo-newborn_sex_child2
newborn_sex_child3	Combo-newborn_sex_child3
newborn_weight_gr	Numeric
newborn_weight_gr_child2	Numeric
newborn_weight_gr_child3	Numeric
newborn_apgar_1min	Numeric
newborn_apgar_1min_child2	Numeric
newborn_apgar_1min_child3	Numeric
newborn_apgar_5min	Numeric
newborn_apgar_5min_child2	Numeric
newborn_apgar_5min_child3	Numeric
newborn_apgar_10min	Numeric
newborn_apgar_10min_child2	Numeric
newborn_apgar_10min_child3	Numeric
newborn_deformity	Boolean
newborn_deformity_child2	Boolean
newborn_deformity_child3	Boolean
newborn_obstetrical_trauma	Boolean
newborn_obstetrical_trauma_child2	Boolean
newborn_obstetrical_trauma_child3	Boolean
newborn_vitamink1	Boolean
newborn_vitamink1_child2	Boolean
newborn_vitamink1_child3	Boolean
treatment_ophtalmic_tetracycline	Boolean
treatment_ophtalmic_tetracycline_child2	Boolean
treatment_ophtalmic_tetracycline_child3	Boolean
neonatal_vaccination_polio	Boolean
neonatal_vaccination_polio_child2	Boolean
neonatal_vaccination_polio_child3	Boolean
neonatal_vaccination_hepb0	Boolean
neonatal_vaccination_hepb0_child2	Boolean
neonatal_vaccination_hepb0_child3	Boolean
neonatal_vaccination_bcg0	Boolean
neonatal_vaccination_bcg0_child2	Boolean
neonatal_vaccination_bcg0_child3	Boolean
neonatal_resuscitation	Boolean
neonatal_resuscitation_child2	Boolean
neonatal_resuscitation_child3	Boolean
neonatal_transfer	Boolean
neonatal_transfer_child2	Boolean
neonatal_transfer_child3	Boolean
newborn_maternal_feeding	Boolean
newborn_maternal_feeding_child2	Boolean
newborn_maternal_feeding_child3	Boolean
newborn_puerperium_return	Boolean
newborn_puerperium_return_child2	Boolean
newborn_puerperium_return_child3	Boolean
_title_del_24	Title
_title_del_25	Title
postpartum_outcome	Combo-postpartum_outcome
postpartum_uterine_atony	Boolean
postpartum_haemorrhage	Boolean
postpartum_htn	Boolean
postpartum_preeclampsia	Boolean
postpartum_eclampsia	Boolean
postpartum_fever	Boolean
puerperium_outcome	Combo-puerperium_outcome
puerperium_stay_duration	Numeric
puerperium_uterine_atony	Boolean
puerperium_pph	Boolean
puerperium_htn	Boolean
puerperium_preeclampsia	Boolean
puerperium_eclampsia	Boolean
puerperium_breastfeeding	Boolean
puerperium_infection	Boolean
puerperium_treatment_atb	Boolean
puerperium_treatment_mg_sulfate	Boolean
puerperium_treatment_uterotonics	Boolean
puerperium_treatment_transfusion	Boolean
puerperium_treatment_other	Boolean
contraception_proposed	Boolean
contraception_accepted	Boolean
contraception_method	Combo-contraception_method
comments	Coded
