_title_ab_01	Title
_title_ab_02	Title
antecedents_htn	Boolean
antecedents_diabetes	Boolean
antecedents_medical_other	Coded
_title_ab_03	Title
antecedents_csection	Boolean
antecedents_surgical_other	Coded
_title_ab_04	Title
antecedents_gestity	Numeric
antecedents_parity	Numeric
antecedents_children_born_living_nb	Numeric
antecedents_stillbirth_nb	Numeric
antecedents_misscarriage_nb	Numeric
antecedents_abortion_nb	Numeric
antecedents_children_living_nb	Numeric
_title_ab_05	Title
_title_ab_06	Title
estimated_as	Numeric
_title_ab_07	Title
admission_cause_spontaneous_labour	Boolean
admission_cause_rom	Boolean
admission_cause_bleeding	Boolean
admission_cause_top_demand	Boolean
_title_ab_08	Title
admission_exam_htn	Boolean
admission_exam_hypotension	Boolean
admission_exam_fever	Boolean
admission_exam_anemia	Boolean
_title_ab_09	Title
top_treatment_before_admission_details	Coded
_title_ab_10	Title
_title_ab_11	Title
admission_treatment_misoprostol	Boolean
admission_treatment_mifepristone	Boolean
treatment_mva	Boolean
treatment_mva_by	Coded
treatment_mva_place	Coded
treatment_curetage	Boolean
treatment_curetage_by	Coded
treatment_curetage_place	Coded
admission_treatment_anti_htn	Boolean
admission_treatment_antibiotics	Boolean
admission_treatment_other	Coded
_title_ab_12	Title
treatment_para_cervical_block	Boolean
treatment_blood_transfusion	Boolean
treatment_blood_transfusion_units	Numeric
top_complication	Boolean
top_complication_details	Coded
_title_ab_13	Title
contraception_proposed	Boolean
contraception_accepted	Boolean
contraception_method	Combo-contraception_method
comments	Coded
