sex	Combo-sex	Sex
_title_01P	Title
admission_date	Date
admission_time	Time
discharge_date	Date
_title_02P	Title
_title_03P	Title
address_village	Combo-address_village
address_village_other	Coded
address_district	Combo-address_district
address_district_other	Coded
_title_04P	Title
_title_05P	Title
referred_in	Combo-referred_in
referred_by	Combo-referred_by
hospitalization_cause	Combo-hospitalization_cause
hospitalization_cause_other	Coded
_title_06P	Title
_title_07P	Title
diagnosis_final_main	Combo-diagnosis_final_main
diagnosis_final_main_other	Coded
diagnosis_final_secondary_1	Combo-diagnosis_final_secondary_1
diagnosis_final_secondary_2	Combo-diagnosis_final_secondary_2
diagnosis_final_secondary_other	Coded
_title_08P	Title
complications_during_treatment_1	Combo-complications_during_treatment_1
complications_during_treatment_2	Combo-complications_during_treatment_2
complications_during_treatment_3	Combo-complications_during_treatment_3
complications_during_treatment_other	Coded
_title_09P	Title
_title_10P	Title
treatment_outcome	Combo-treatment_outcome
referral_external_place_1	Combo-referral_external_place_1
referral_external_cause	Combo-referral_external_cause
death_time	Time
death_48h	Combo-death_48h
death_cause	Combo-death_cause
death_cause_other	Coded
death_unit	Combo-death_unit
_title_11P	Title
_title_12P	Title
fup_needed	Combo-fup_needed
fup_by	Combo-fup_by
fup_date_first	Date
_title_13P	Title
treatment_at_discharge_1	Combo-treatment_at_discharge_1
treatment_at_discharge_2	Combo-treatment_at_discharge_2
treatment_at_discharge_3	Combo-treatment_at_discharge_3
_title_14P	Title
comments	Coded
