_title_measles_01	Title
admission_time	Time
referred_in	Combo-referred_in
_title_measles_02	Title
_title_measles_03	Title
muac	Combo-muac
muac_discharge	Combo-muac_discharge
oedema	Combo-oedema
oedema_discharge	Combo-oedema_discharge
_title_measles_04	Title
_title_measles_05	Title
measles_case	Combo-measles_case
vaccinal_status_measles	Combo-vaccinal_status_measles
vaccinal_status_measles_card	Combo-vaccinal_status_measles_card
complication_measles_main	Combo-complication_measles_main
complication_measles_associated	Combo-complication_measles_associated
complication_measles_other	Coded
_title_measles_06	Title
_title_measles_07	Title
rdt_malaria	Combo-rdt_malaria
blood_transfusion_bags_nb	Numeric
complication_malaria_main	Combo-complication_malaria_main
complication_malaria_associated	Combo-complication_malaria_associated
complication_malaria_other	Coded
_title_measles_10	Title
_title_measles_11	Title
discharge_date	Date
discharge_time	Time
treatment_outcome	Combo-treatment_outcome
death_cause	Combo-death_cause
death_cause_other	Coded
_title_measles_12	Title
comments	Coded
_title_measles_13	Title
