_title_hiv_01	Title
hiv_entry_mode	Combo-hiv_entry_mode
hiv_entry_mode_other	Coded
hiv_rapid_test_positive_first_date	Date
// pregnancy_date_last	Date
_title_hiv_02	Title
hiv_stage	Combo-hiv_stage
height	Decimal-1
cd4_baseline	Numeric
hbv_positive	Boolean
hcv_positive	Boolean
_title_hiv_04	Title
_title_hiv_05	Title
hiv_tb_coinfection	Boolean
tb_case_definition	Combo-tb_case_definition
tb_treatment_start_date	Date
tb_treatment_category	Combo-tb_treatment_category
ipt_last_date	Date
ipt_courses_received	Numeric
_title_hiv_07	Title
_title_hiv_08	Title
treatment_arv_start_date	Date
treatment_arv_start_regimen	Combo-treatment_arv_start_regimen
treatment_arv_current_regimen	Combo-treatment_arv_current_regimen
treatment_arv_line2_start_date	Date
treatment_arv_line2_start_regimen	Combo-treatment_arv_line2_start_regimen
prophylaxis_cotrimoxazole	Boolean
prophylaxis_dapsone	Boolean
prophylaxis_fluconazole	Boolean
observance_problem	Boolean
_title_hiv_09	Coded
_title_hiv_10	Title
treatment_outcome_lfup	Boolean
treatment_outcome_lfup_date	Date
treatment_outcome_transferred	Boolean
treatment_outcome_transferred_date	Date
treatment_outcome_dead	Boolean
treatment_outcome_death_date	Date
treatment_outcome_death_hiv	Boolean
_title_hiv_11	Coded
appointment_next_date	Date
comments	Coded
